1111111111111
10010000000C1
1000011111011
100011000E001
1000110000001
1000110000001
1000110000001
1000110000001
1000110000001
10C0110000001
1000110000001
1000110000001
1000111000P01
10001110000C1
1111111111111