1111111111111
1001000000001
1000011111001
100011000E001
100011000P001
1000110000001
1000110000001
1000110000001
1000110000001
1000110000001
1000110000001
1000110000001
1000111000001
1000111000001
1111111111111 