1111111111111
10010000000C1
10P0011111001
1000110000001
1000110000001
1000110000001
1000110000001
1000110000001
1000110000001
10C0110000001
1000110000001
1000110000001
1000111000001
10001110000C1
1111111111111 